C-dur: C D E F G A H C
G-dur: G A H C D E Fis G
D-dur: D E Fis G A H Cis D
A-dur: A H Cis D E Fis Gis A
E-dur: E Fis Gis A H Cis Dis E
H-dur: H Cis Dis E Fis Gis Ais H
Fis-dur: Fis Gis Ais H Cis Dis Eis Fis
Cis-dur: Cis Dis Eis Fis Gis Ais His Cis
F-dur: F G A B C D E F
B-dur: B C D Es F G A B
Es-dur: Es F G As B C D Es
As-dur: As B C Des Es F G As
Des-dur: Des Es F Ges As B C Des
Ges-dur: Ges As B Ces Des Es F Ges
Ces-dur: Ces Des Es Fes Ges As B Ces
A-moll: A H C D E F G A
E-moll: E Fis G A H C D E
H-moll: H Cis D E Fis G A H
Fis-moll: Fis Gis A H Cis D E Fis
Cis-moll: Cis Dis E Fis Gis A H Cis
Gis-moll: Gis Ais H Cis Dis E Fis Gis
Dis-moll: Dis Eis Fis Gis Ais H Cis Dis
Ais-moll: Ais His Cis Dis Eis Fis Gis Ais
D-moll: D E F G A B C D
G-moll: G A B C D Es F G
C-moll: C D Es F G As B C
F-moll: F G As B C Des Es F
B-moll: B C Des Es F Ges As B
Es-moll: Es F Ges As B Ces Des Es
As-moll: As B Ces Des Es Fes Ges As